000000000000000000000000000000000000000000000000000000000000000000000000
000000002000002000000000000000000000000000200000020000000000000000000000
000000001111111110000000000020000000000001110001111100000000000000000000
000000011111000100002000001111000000000001110001111100010002000000000000
000000111111002100011110001110000000000000000000000000000011100000000000
000001111111001100001100001100000000000000000000000000000001100000000000
000011111111000110001100011000000000000000200001110200011001110000000000
020111111111100000001102001020000200002001110001111110011001110200000020
111111111111110200011111111111111111111111110001111110000001111110001111
111111111111111111111111111111111111111111110001111110000001111110001111