0000000000000000110000000000000000000000000000000000000000000000000000000000
0000000000000000110000020000002000000000000000200000000020000000000000000020
0000000000000000110001111100011100111000000001110000000111000000000000000111
0000000000000000110000111000011100011100000000000000000000000200000000001111
0000000000000000111000111000011100011110000000000011100000001110000000011111
0000000000020000000000111000000000011111000000000000000000000000000000111111
0000001100111000000001111000000000011111100001110000000111000000000001111111
0020001100111000000000111000000000011111110001110002000000000000002011111111
1111000000000001111111111000000000011111111111110011100000000000011111111111
1111000000000001111111111000000000011111111111110000000000000000011111111111