0000000000
0200000020
1110000010
1110000010
1110010010