0000000000
0000000000
0200000000
0100010000
0000000011
0000000000
0300011000
0110011000
0110000000
0000000000