0000000000
0000000020
0000000011
0000000111
0000001111
0000011111
0000111111
0301111111
1111111111
1111111111