0000000000
0200000000
1111110000
1000100000
1002100011
1001100001
1000110001
1100000001
1110300011
1111111111