0000000000
0300000000
1110001110
1110001110
0000000000
0000000000
0200001111
1110001111
1110001111
1110001111