0000000000
0000000000
0000000000
0000000000
0000000000
0000000000
0000000000
0300000020
1110001111
1110001111