0000000000
0000000000
0000000000
0000011110
1100011100
1000011000
1000110000
1030010200
1111111111
1111111111