0000000000
0000000000
0000000000
0000000000
0000000000
0000000000
0000000000
0030000200
1111111111
1111111111